F...#########################################################
......#..#.....#...........#..#........#........#.....#.....#
####..#..#..####..#######..#..####..####..####..#..####..#..#
#..............#.....#..#..#...........#.....#..#........#..#
#######..##########..#..####..#..#..####..#..#..#..#..#..#..#
#.............................#..#........#..#.....#..#..#..#
#..################..#..#..#############..####..#############
#........#........#..#..#.....#..#..#.....#..#..#...........#
####..#..#..#..####..####..####..#..#..#..#..#######..####..#
#.....#..#..#..#..#.....#..#..#........#.....#...........#..#
#..#######..#..#..#..#######..#############..#..####..#######
#...........#..#..#..#..#..#.....#.....#.....#.....#........#
#######..#######..####..#..####..#..#######..#..#..#######..#
#........#........#........#..#.....#...........#..#........#
####..#..#######..#######..#..#..#######..#..#..##########..#
#.....#..............#........#........#..#..#.....#........#
#..################..####..####..####..####..#############..#
#.....#.....#..#..#...........#..#.....#.....#..#.....#.....#
#..#..#..#..#..#..#..#######..#######..#..####..#..#..####..#
#..#.....#..#.....#.....#..#..#........#..#........#..#.....#
####..##########..#..#..#..#######..####..#..####..####..####
#.....#.....#..#.....#..#..#.....#...........#..#.....#.....#
#..#..#..####..####..####..#..####..#######..#..#############
#..#..#........#..#..#..............#..#.................#..#
#..####..####..#..#..#..#######..####..#..#..####..#######..#
#..#..#..#..#.....#..#..#..#...........#..#..#........#.....#
#..#..####..#..##########..####..####..#######..#..#..####..#
#.....#..#.....#...........#..#..#........#..#..#..#..#.....#
#..####..####..#######..#..#..#######..####..#######..#..#..#
#..#..#..#.....#........#........#........#..#........#..#..#
#..#..#..#..####..####..####..#######..####..##########..####
#..............#.....#..#..#.....#..#.....#........#..#.....#
#..#######..#..#######..#..####..#..#..####..####..#..#..####
#.....#.....#..#..#........#..#.................#..#........#
#..#..#..#..####..#..####..#..###################..#..####..#
#..#..#..#.....#..#..#..#..#.....#.....#.....#.....#.....#..#
#..#######..####..####..####..#..#..#######..#..##########..#
#.....#.....#..............#..#........#..#.....#.....#.....#
#######..#..####..####..#############..#..#..#..#..####..####
#........#........#..............#...........#..............
##########################################################..S
