S...###########################
...#........#........#........#
#..#..#..#..#..####..#..####..#
#.....#..#..#..#...........#..#
##########..#############..#..#
#..............#.....#.....#..#
#..#############..#..#..#######
#..#..#.....#.....#...........#
#..#..#..##########..#..#######
#....................#..#.....#
#######..####..#######..#..#..#
#.....#.....#........#.....#..#
#..##########..#############..#
#........#........#..#........#
#######..####..#..#..####..####
#..............#.....#.....#..#
#..####..####..#..#..####..#..#
#..#.....#.....#..#..#........#
#############..#..#############
#..............#..............
############################.F